Humans: 200  
RRRRRRRRRRRRRRRRRRRR
R..................R
R.@................R
R..............Z...R
RRRRRRRRRRRRRRRRRRRR